11111111111111111111111111111111111111111111
14000000000000000000000000000000000000000001
10000000000000000000000000000000000000000001
10000000000000000000000000000000000000000001
10000000000000000000000000000000000000000001
10000000000000000000000000000000000000000001
10000000000000000000000000000000000000000001
10000000000000000000000000000000000000000001
10000000000000000000000000000000000000000001
10000000000000000000000000000000000000000001
10000000000000000000000000000000000000000001
10000000000000000000000000000000000000000001
10000000000000000000000000000000000000000001
10000000000000000000000000000000000000000001
10000000000000000000000000000000000000000001
10000000000000000000000000000000000000000001
10000000000000000000000000000000000000000001
10000000000000000000000000000000000000000001
10000000000000000000000000000000000000000001
10000000000000000000000000000000000000000001
10000000000000000000000000000000000000000001
10000000000000000000000000000000000000000001
11111111111111111111111111111111111111111111